FTT.GTGTT
GT..TTTTT
T.TGTTGTT
TT.TTTTTT
TGGGGGTTT
TTTTTTTTP