PTTGTT.TST
TST..TSTTT
T.TTTTTTTT
T.TST..TTT
T.TTTG.STT
T.T.TT.TTT
T.TGTGGTTF