TTTGST.TTT
TTTT.TTTTM
TTT..TTTTT
S.TTMT.TTS
..TTTGMTTT
..TMT.M.TT
.TTTTTMSTT
..TTST..TG
.TGT..MTTT
.TT..MTTTP