TTTGTT.TTF
TTST.TTTTM
TTT..TTTTS
S.TTMT.TTT
..TTTGMTTT
..TMT.MTST
.TTTTTMSTT
..TSST..TG
.TGT..MTTT
.TT..MTTTP