PTTGTT TS
TST  TSTT
TTTTTTSTT
T TSTS TT
T TTTG ST
TSTSTT TT